w w w w w w w w w w w w w w w w w w w w w w w w w w w w w w w w w w w w w w w w w w w w w w w w w w w w w w w w w w w w w w w w
w w w w w w w w w w w w w w w w w w s w w w w w w w w w w w w w w w w w w w w w w w w w w w w w w w w w w w w w w w w w w w w w
w w w w w w w w w w w w w w w w w s s w w w w w w w w w w w w w w w w w w w w w w w w w w w w w w w w w w w w w w w w w w w w w
w w w w w w w w w w w w w w w w s f s w w w w w w w w w w w w w w w w w w w w w w w w w w w w w w w w w w w w w w w w w w w w w
w w w w w w w w w w s s s w w s s s w w w w w w w w w w w w w w w w w w w w w w w w w w w w w w w w w w w w w w w w w w w w w w
w w w w w w w w w w s g s w s s f s w w w w w w w w w w w w w w w w w w w w w w w w w w w w w w w w w w w w w w w w w w w w w w
w w w w w w w w s s s g s s s f s s w w w w w w w w w w w w w w w w w s s s s s s s s s s w w w w w w w w w w w w w w w w w w w
w w w w w w w s s g g g g g g s s w w w w w w w w w w w w w w w w w w s f s f f f f s f s w w w w w w w w w w w w w w w w w w w
w w w w w w w s g g g g s g g s w w w w w w w w w w w w w w w w w w w s f s f f f f s f s w w w w w w w w w w w w w w w w w w w
w w w w w w w s g g g g g g g s s w w w w w w w w w w w w w w w w w w s f s f f f f s f s w w w w w w w w w w w w w w w w w w w
w w w w w w w s g g g g g g g g s s w w w w w w w w w w w w w w w w w s f s f f f f s f s w w w w w w w w w w w w w w w w w w w
w w w w w w w s g g g g g g g g g s w w w w w w w w w w w w w w w w w s f s f f f f s f s w w w w w w w w w w w w w w w w w w w
w w w w w w w s g g g g g g s s s s w w w w w w w w w w w w w w w w w s f s f f f f s f s w w w w w w w w w w w w w w w w w w w
w w w w w w w s s s s s s s s w w w w w w w w w w w w w w w w w w w w s s s s s s s s s s w w w w w w w w w w w w w w w w w w w
w w w w w w w w w w w w w w w w w w w w w w w w w w w w w w w w w w w w w w w w w w w w w w w w w w w w w w w w w w w w w w w w
w w w w w w w w w w w w w w w w w w w w w w w w w w w w w w w w w w w w w w w w w w w w w w w w w w w w w w w w w w w w w w w w
w w w w w w w w w w w w w w w w w w w w w w w w w w w w w w w w w w w w w w w w w w w w w w w w w w w w w w w w w w w w w w w w
w w w w w w w w w w w w w w w w w w w w w w w w w w w w w w w w w w w w w w w w w w w w w w w s s s s w w w w w w w w w w w w w
w w w w w w w w w w w w w w w w w w w w w w w w w w w w w w w w w w w w w w w w w w w w w w s s g s s s s w w w w w w w w w w w
w w w w w w w w w w w w w w w w w w w w w w w w w w w w w w w w w w w w w w w w w w w w w s s s g g g s s w w w w w w w w w w w
w w w w w w w w s s s w w w w w w w w w w w w w w w w w w w w w w w w w w w w w w w w w w s s g g g g g s s w w w w w w w w w w
w w w w w w w s s g g s s w w w w w w w w w w w w w w w w w w w w w w w w w w w w w w w w w s g g g g g s s w w w w w w w w w w
w w w w w w s g g g g s g s w w w w w w w w w w w w w w w w w w w w w w w w w w w w w w w w s s g g g g s s w w w w w w w w w w
w w w w w s g g g g g g g s w w w w w w w w w w w w w w w w w w w w w w w w w w w w w w w w s s s s s g s s w w w w w w w w w w
w w w w w s g g g g g g g s w w w w w w w w w w w w w w w w w w w w w w w w w w w w w w w w w s s s s s s s w w w w w w w w w w
w w w w w s s g g g g g g s w w w w w w w w w w w w w w w w w w w w w w w w w w w w w w w w w w w s w w w w w w w w w w w w w w
w w w w w w w s g g g g s s w w w w w w w w w w w w w w w w w w w w w w w w w w w w w w w w w w w w w w w w w w w w w w w w w w
w w w w w w w w s s g g s w w w w w w w w w w w w w w w w w w w w w w w w w w w w w w w w w w w w w w w w w w w w w w w w w w w
w w w w w w w w w w s s w w w w w w w w w w w w w w w w w w w w w w w w w w w w w w w w w w w w w w w w w w w w w w w w w w w w
w w w w w w w w w w w w w w w w w w w w w w w w w w w w w w w w w w w w w w w w w w w w w w w w w w w w w w w w w w w w w w w w
w w w w w w w w w w w w w w w w w w w w w w w w w w w w w w w w w w w w w w w w w w w w w w w w w w w w w w w w w w w w w w w w
w w w w w w w w w w w w w w w w w w w w w w w w w w w w w w w w w w w w w w w w w w w w w w w w w w w w w w w w w w w w w w w w
w w w w w w w w w w w w w w w w w w w w w w w w w w w w w w w w w w w w w w w w w w w s s s w w w w w w w w w w w w w w w w w w
w w w w w w w w w w w w w w w w w w w w w w w w w w w w w w w w w w w w w w w w w w s s s s s s w w w w w w w w w w w w w w w w
w w w w w w w s s s w w w w w w w w w w w w w w w w w w w w w w w w w w w w w w w s s s f s s s s w w w w w w w w w w w w w w w
w w w w w w s g g s w w w w w w w w w w w w w w w w w w w w w w w w w w w w w w w s s f f f s s s s w w w w w w w w w w w w w w
w w s s s w w s g g s w s s s w w w w w w w w w w w w w w w w w w w w w w w w w w s s f f f f s s w w w w w w w w w w w w w w w
w s g g g s s s g g g s g g g s w w w w w w w w w w w w w w w w w w w w w w w w w s s s s f s s s w w w w w w w w w w w w w w w
w w s s g g g g g g g g s s g g s w w w w w w w w w w w w w w w w w w w w w w w w w s s s s s s w w w w w w w w w w w w w w w w
w w w w s g g g g g g g s f s g g s w w w w w w w w w w w w w w w w w w w w w w w w w w s s s w w w w w w w w w w w w w w w w w
w w w s s g g g g g g g g s g g g s w w w w w w w w w w w w w w w w w w w w w w w w w w w w w w w w w w w w w w w w w w w w w w
w w w s g g g g g g g g g g g g g s w w w w w w w w w w w w w w w w w w w w w w w w w w w w w w w w w w w w w w w w w w w w w w
w w w s g g g s s s s g g g g s s w w w w w w w w w w w w w w w w w w w w w w w w w w w w w w w w w w w w w w w w w w w w w w w
w w s g g s s w w w w s s s s s w w w w w w w w w w w w w w w w w w w w w w w w w w w w w w w w w w w w w w w w w w w w w w w w
w w w s s w w w w w w w w w w w w w w w w w w w w w w w w w w w w w w w w w w w w w w w w w w w w w w w w w w w w w w w w w w w
w w w w w w w w w w w w w w w w w w w w w w w w w w w w w w w w w w w w w w w w w w w w w w w w w w w w w w w w w w w w w w w w
w w w w w w w w w w w w w w w w w w w w w w w w w w w w w w w w w w w w w w w w w w w w w w w w w w w w w w w w w w w w w w w w
w w w w w w w w w w w w w w w w w w w w w w w w w w w w w w w w w w w w w w w w w w w w w w w w w w w w w w w w w w w w w w w w
w w w w w w w w w w w w w w w w w w s s w w w w w w w w w w w w w w w w w w w w w w w w w w w w w w w w w w w w w w w w w w w w
w w w w w w w w w w w w w w w w w s s s s s w w w w w w w w w w w w w w w w w w w w w w w w w w w w w w w w w w w w w w w w w w
w w w w w w w w w w w w w w w w s s s f s s s w w w w w w w w w w w w w w w w w w w w w w w w w w w w w w w w w w w w w w w w w
w w w w w w w w w w w w w w w w s s f f f s s s w w w w w w w w w w w w w w w w w w w w w w w w w w w w w w w w w w w w w w w w
w w w w w w w w w w w w w w w s s f f f f f s s w w w w w w w w w w w w w w w w w w w w w w w w w w w w w w w w w w w w w w w w
w w w w w w w w w w w w w w w w s s f f f s s s w w w w w w w w w w w w w w w w w w w w w w w w w w w w w w w w w w w w w w w w
w w w w w w w w w w w w w w w w s s s f s s s s w w w w w w w w w w w w w w w w w w w w w w w w w w w w w w w w w w w w w w w w
w w w w w w w w w w w w w w w w w s s s s s w w w w w w w w w w w w w w w w w w w w w w w w w w w w w w s s s s w w w s s s w w
w w w w w w w w w w w w w w w w w w w s w w w w w w w w w w w w w w w w w w w w w w w w w w w w w w w s g g g s w s s s g s s w
w w w w w w w w w w w w w w w w w w w w w w w w w w w w w w w w w w w w w w w w w w w w w w w w w w w s s g g s w s g s g s g s
w w w w w w w w w w w w w w w w w w w w w w w w w w w w w w w w w w w w w w w w w w w w w w w w w w s g g s g s s s g s g s g s
w w w w w w w w w w w w w w w w w w w w w w w w w w w w w w w w w w w w w w w w w w w w w w w w w w w s s g g g g g s s s g s s
w w w w w w w w w w w w w w w w w w w w w w w w w w w w w w w w w w w w w w w w w w w w w w w w w w w w s g s g g g g g s g s w
w w w w w w w w w w w w w w w w w w w w w w w w w w w w w w w w w w w w w w w w w w w w w w w w w w w w w s s g g g g g g s w w
w w w w w w w w w w w w w w w w w w w w w w w w w w w w w w w w w w w w w w w w w w w w w w w w w w w w w w s s s g s g s w w w
w w w w w w w w w w w w w w w w w w w w w w w w w w w w w w w w w w w w w w w w w w w w w w w w w w w w w w w s g g g g s w w w
